SurveyDay,NumberOf12HourDays,RefRoad,NLightLorries_12,NMediumLorries_12,NHeavyLorries_12,NVeryHeavyLorries_12,NLargeBuses_12,Total,Region
1,3,1,1,14,15,16,18,64,ARUSHA
2,1,1,114,169,146,220,190,839,ARUSHA
1,1,1,166,287,160,190,225,1028,ARUSHA
2,1,1,34,33,35,36,38,176,ARUSHA
2,1,1,444,366,311,299,289,1709,ARUSHA
2,1,1,277,267,234,224,239,1241,ARUSHA
2,1,1,166,230,44,52,34,526,ARUSHA
2,1,1,46,124,83,63,19,335,ARUSHA
2,1,1,16,65,12,57,17,167,ARUSHA
3,1,1,5,61,38,70,13,187,ARUSHA
2,1,1,23,44,33,52,25,177,ARUSHA
3,1,1,18,80,34,7,14,153,ARUSHA
3,1,1,9,45,52,61,134,301,ARUSHA
3,1,1,71,143,67,82,134,497,ARUSHA
3,1,1,608,457,243,323,217,1848,ARUSHA
4,1,1,6,16,5,1,16,44,ARUSHA
2,1,1,35,42,9,7,12,105,ARUSHA
1,1,1,17,56,7,11,19,110,ARUSHA
3,1,1,3,6,0,0,0,9,ARUSHA
3,1,1,5,34,8,0,1,48,ARUSHA
1,1,1,37,29,30,1,5,102,ARUSHA
3,1,1,20,7,11,7,2,47,ARUSHA
3,1,1,85,18,5,4,18,130,ARUSHA
2,1,1,0,0,0,0,0,0,ARUSHA
2,1,1,2,21,0,0,0,23,ARUSHA
1,1,1,3,20,5,1,3,32,ARUSHA
3,1,1,0,1,0,1,4,6,ARUSHA
3,1,1,1,2,2,0,4,9,ARUSHA
3,1,1,4,33,7,4,7,55,ARUSHA
1,1,1,0,13,13,0,1,27,ARUSHA
1,1,1,1,6,27,2,2,38,ARUSHA
1,1,1,10,14,24,6,2,56,ARUSHA
1,1,1,4,7,0,0,1,12,ARUSHA
4,1,1,379,293,105,21,48,846,ARUSHA
1,1,1,85,62,30,2,1,180,ARUSHA
5,1,1,25,61,32,8,1,127,ARUSHA
1,1,1,132,225,37,3,12,409,ARUSHA
1,1,1,24,52,13,78,1,168,ARUSHA
2,1,1,0,4,0,0,0,4,ARUSHA
3,1,1,3,0,0,0,0,3,ARUSHA
3,1,1,17,56,7,11,19,110,ARUSHA
2,1,1,11,49,9,5,3,77,ARUSHA
4,1,1,191,308,184,59,35,777,ARUSHA
3,1,1,10,31,139,3,8,191,ARUSHA
1,1,1,24,14,145,1,8,192,ARUSHA
2,1,1,4,12,6,0,0,22,ARUSHA
3,1,1,2,10,5,0,0,17,ARUSHA
3,1,1,0,2,1,0,0,3,ARUSHA
2,1,1,2,21,0,0,0,23,ARUSHA
2,1,1,6,12,4,0,2,24,ARUSHA
2,1,1,1,11,7,0,3,22,ARUSHA
1,1,1,2,2,2,0,0,6,ARUSHA
3,1,1,1,11,2,0,0,14,ARUSHA
1,1,1,13,20,9,3,5,50,ARUSHA
3,1,1,10,31,0,7,3,51,ARUSHA
2,1,2,166,1157,157,1452,635,3567,COAST
4,1,2,305,1092,284,1107,605,3393,COAST
1,1,2,327,994,219,1351,523,3414,COAST
5,1,2,306,1092,284,1107,605,3394,COAST
4,1,2,105,217,37,1505,516,2380,COAST
5,1,2,101,159,76,1338,588,2262,COAST
5,1,2,33,150,44,1340,418,1985,COAST
4,1,2,135,154,135,1554,554,2532,COAST
4,1,2,32,56,32,470,286,876,COAST
5,1,2,31,43,15,324,113,526,COAST
4,1,2,23,36,12,591,160,822,COAST
5,1,2,166,297,146,809,661,2079,COAST
1,1,2,29,42,12,197,244,524,COAST
4,1,2,36,86,35,218,308,683,COAST
5,1,2,156,238,165,147,119,825,COAST
2,1,2,140,188,201,182,107,818,COAST
5,1,2,46,73,40,145,91,395,COAST
2,1,2,45,40,34,169,115,403,COAST
4,1,2,32,30,15,93,130,300,COAST
2,1,2,46,59,35,195,124,459,COAST
5,1,2,53,40,18,177,94,382,COAST
5,1,2,15,63,40,164,119,401,COAST
4,1,2,215,136,604,57,7,1019,COAST
4,1,2,213,133,137,284,141,908,COAST
5,1,2,104,94,86,292,113,689,COAST
4,1,2,132,98,17,279,140,666,COAST
3,1,2,1,2,0,0,1,4,COAST
2,1,2,4,1,2,4,2,13,COAST
4,1,2,7,20,2,0,3,32,COAST
3,1,2,12,7,2,3,7,31,COAST
4,1,2,72,57,1,4,6,140,COAST
2,1,2,31,51,2,0,3,87,COAST
2,1,2,21,11,0,2,0,34,COAST
3,1,2,28,68,77,227,3,403,COAST
3,1,2,2,11,0,0,4,17,COAST
4,1,2,37,17,0,0,0,54,COAST
5,1,2,127,75,33,5,3,243,COAST
2,1,2,98,37,9,10,10,164,COAST
1,1,2,25,20,2,1,2,50,COAST
4,1,2,80,42,26,3,4,155,COAST
2,1,2,81,65,23,3,14,186,COAST
5,1,2,35,59,40,42,27,203,COAST
2,1,2,10,15,4,2,26,57,COAST
4,1,2,40,37,5,9,22,113,COAST
2,1,2,1,16,2,0,0,19,COAST
3,1,2,0,6,4,37,5,52,COAST
4,1,2,2,6,3,28,7,46,COAST
2,1,2,0,82,3,1,0,86,COAST
2,1,2,8,0,38,54,0,100,COAST
4,1,2,28,13,0,3,2,46,COAST
4,1,2,9,21,0,0,0,30,COAST
2,1,2,11,18,6,9,7,51,COAST
5,1,2,11,18,6,9,7,51,COAST
2,1,2,3,7,0,3,9,22,COAST
4,1,2,0,7,0,0,9,16,COAST
4,1,2,7,4,0,0,0,11,COAST
2,1,2,19,23,0,0,0,42,COAST
4,1,2,19,2,0,0,0,21,COAST
4,1,2,46,65,7,20,1,139,COAST
4,1,2,19,13,3,0,0,35,COAST
5,1,3,15,58,48,810,193,1124,DODOMA
1,1,3,77,105,559,279,213,1233,DODOMA
2,1,3,13,38,76,750,248,1125,DODOMA
4,1,3,102,259,114,1076,284,1835,DODOMA
2,1,3,60,272,119,913,513,1877,DODOMA
4,1,3,244,195,223,1097,375,2134,DODOMA
5,1,3,258,504,112,657,322,1853,DODOMA
4,1,3,133,564,130,916,215,1958,DODOMA
5,1,3,133,564,130,916,215,1958,DODOMA
4,1,3,107,44,96,659,170,1076,DODOMA
5,1,3,46,663,67,912,181,1869,DODOMA
5,1,3,21,68,43,859,186,1177,DODOMA
4,1,3,11,38,11,108,54,222,DODOMA
1,1,3,2,11,8,34,40,95,DODOMA
1,1,3,18,28,29,133,51,259,DODOMA
1,1,3,18,28,29,133,51,259,DODOMA
4,1,3,40,42,40,122,84,328,DODOMA
2,1,3,33,359,44,145,77,658,DODOMA
5,1,3,54,99,8,3,64,228,DODOMA
2,1,3,168,207,52,24,60,511,DODOMA
2,1,3,157,146,128,905,301,1637,DODOMA
3,1,3,55,208,19,29,77,388,DODOMA
4,1,3,10,16,6,9,32,73,DODOMA
5,1,3,19,92,57,33,92,293,DODOMA
5,1,3,13,24,10,0,10,57,DODOMA
1,1,3,7,7,1,0,9,24,DODOMA
1,1,3,16,16,0,0,13,45,DODOMA
5,1,3,0,9,3,0,13,25,DODOMA
5,1,3,0,21,3,0,25,49,DODOMA
5,1,3,2,3,0,0,6,11,DODOMA
4,1,3,1,8,0,3,7,19,DODOMA
4,1,3,0,4,0,0,5,9,DODOMA
3,1,3,0,34,0,0,4,38,DODOMA
5,1,3,2,26,1,0,3,32,DODOMA
2,1,3,0,6,0,0,4,10,DODOMA
5,1,3,1,15,2,17,27,62,DODOMA
4,1,3,95,143,23,0,55,316,DODOMA
4,1,3,13,40,4,0,0,57,DODOMA
2,1,3,2,49,29,2,11,93,DODOMA
5,1,3,0,3,4,0,1,8,DODOMA
5,1,3,0,2,0,0,3,5,DODOMA
4,1,3,11,12,66,0,3,92,DODOMA
5,1,3,24,21,41,8,5,99,DODOMA
4,1,3,5,41,6,0,12,64,DODOMA
3,1,3,8,2,9,3,24,46,DODOMA
4,1,3,8,62,18,6,13,107,DODOMA
5,1,3,2,15,5,1,13,36,DODOMA
4,1,3,1,6,1,0,8,16,DODOMA
3,1,3,0,4,0,0,4,8,DODOMA
3,1,3,0,1,0,1,0,2,DODOMA
3,1,3,0,1,3,0,0,4,DODOMA
5,1,3,131,172,39,4,294,640,DODOMA
3,1,3,0,1,0,0,3,4,DODOMA
5,1,3,1,13,1,0,4,19,DODOMA
1,1,3,0,9,0,0,4,13,DODOMA
4,1,3,2,4,3,0,0,9,DODOMA
4,1,3,1,5,1,3,6,16,DODOMA
3,1,3,18,2,12,6,5,43,DODOMA
4,1,3,3,18,7,0,2,30,DODOMA
1,1,3,3,13,0,1,14,31,DODOMA
5,1,3,0,3,0,0,2,5,DODOMA
5,1,3,54,99,8,3,64,228,DODOMA
2,1,4,180,122,8,4,195,509,DAR ES SALAAM
3,1,4,336,255,142,81,1211,2025,DAR ES SALAAM
1,1,4,336,212,151,99,1505,2303,DAR ES SALAAM
1,1,4,444,423,232,1037,1316,3452,DAR ES SALAAM
1,1,4,843,321,167,1010,1438,3779,DAR ES SALAAM
1,1,4,428,969,212,874,482,2965,DAR ES SALAAM
1,1,4,769,407,287,855,708,3026,DAR ES SALAAM
1,1,4,313,161,182,273,11,940,DAR ES SALAAM
3,1,4,259,222,195,677,1243,2596,DAR ES SALAAM
2,1,4,70,13,0,0,0,83,DAR ES SALAAM
2,1,4,98,31,10,2,5,146,DAR ES SALAAM
4,1,4,156,202,16,2,39,415,DAR ES SALAAM
4,1,4,222,93,9,0,79,403,DAR ES SALAAM
5,1,4,243,288,66,40,5,642,DAR ES SALAAM
7,1,4,162,67,57,240,220,746,DAR ES SALAAM
4,1,4,375,324,378,3455,764,5296,DAR ES SALAAM
5,1,4,496,814,593,286,5267,7456,DAR ES SALAAM
6,1,4,87,48,22,4,0,161,DAR ES SALAAM
4,1,4,238,260,9,0,322,829,DAR ES SALAAM
6,1,4,27,9,4,0,0,40,DAR ES SALAAM
6,1,4,479,562,807,352,1030,3230,DAR ES SALAAM
2,1,4,524,472,509,510,92,2107,DAR ES SALAAM
4,1,4,284,101,18,1,362,766,DAR ES SALAAM
3,1,4,1101,405,100,104,414,2124,DAR ES SALAAM
3,1,4,785,768,252,622,819,3246,DAR ES SALAAM
2,1,4,850,817,386,1200,6,3259,DAR ES SALAAM
7,1,4,711,231,4,0,1740,2686,DAR ES SALAAM
4,1,4,82,124,118,5254,20,5598,DAR ES SALAAM
3,1,4,269,295,195,3343,1458,5560,DAR ES SALAAM
2,1,4,270,342,200,2955,6,3773,DAR ES SALAAM
2,1,4,702,1018,578,1981,27,4306,DAR ES SALAAM
3,1,4,524,750,501,2033,33,3841,DAR ES SALAAM
1,1,4,459,587,260,1109,1207,3622,DAR ES SALAAM
6,1,4,939,439,451,103,4200,6132,DAR ES SALAAM
3,1,4,507,517,252,534,139,1949,DAR ES SALAAM
2,1,4,113,30,6,7,857,1013,DAR ES SALAAM
2,1,4,83,20,2,0,42,147,DAR ES SALAAM
7,1,4,711,231,2,0,1740,2684,DAR ES SALAAM
3,1,4,265,129,67,6,6,473,DAR ES SALAAM
1,1,4,402,264,189,50,926,1831,DAR ES SALAAM
5,1,4,379,310,241,166,705,1801,DAR ES SALAAM
1,1,4,963,1020,820,560,4960,8323,DAR ES SALAAM
3,1,4,507,630,307,496,107,2047,DAR ES SALAAM
4,1,4,506,716,451,1162,573,3408,DAR ES SALAAM
3,1,4,369,380,272,426,243,1690,DAR ES SALAAM
2,1,4,630,495,667,100,255,2147,DAR ES SALAAM
4,1,4,321,232,157,208,117,1035,DAR ES SALAAM
4,1,4,167,113,43,13,1,337,DAR ES SALAAM
4,1,4,54,42,53,4,0,153,DAR ES SALAAM
5,1,4,83,20,34,3,14,154,DAR ES SALAAM
1,1,4,221,68,0,2,26,317,DAR ES SALAAM
4,1,4,116,116,32,4,6,274,DAR ES SALAAM
1,1,4,23,6,0,0,2,31,DAR ES SALAAM
1,1,4,209,103,23,6,42,383,DAR ES SALAAM
4,1,4,232,192,53,6,1,484,DAR ES SALAAM
2,1,4,86,81,31,9,7,214,DAR ES SALAAM
4,1,4,96,123,32,7,20,278,DAR ES SALAAM
5,1,4,172,146,70,7,0,395,DAR ES SALAAM
5,1,4,310,277,60,1,200,848,DAR ES SALAAM
1,1,4,467,70,220,5,620,1382,DAR ES SALAAM
5,1,4,227,237,90,0,0,554,DAR ES SALAAM
4,1,4,240,118,35,0,111,504,DAR ES SALAAM
5,1,4,409,120,18,6,0,553,DAR ES SALAAM
2,1,4,98,18,3,1,5,125,DAR ES SALAAM
5,1,4,279,172,133,168,0,752,DAR ES SALAAM
2,1,4,185,154,49,78,38,504,DAR ES SALAAM
5,1,4,435,199,79,5,28,746,DAR ES SALAAM
4,1,4,148,176,52,61,8,445,DAR ES SALAAM
5,1,4,268,265,35,1,1,570,DAR ES SALAAM
3,1,4,197,60,29,3,4,293,DAR ES SALAAM
1,1,4,379,238,134,12,230,993,DAR ES SALAAM
3,1,4,96,102,37,13,281,529,DAR ES SALAAM
2,1,4,165,212,98,17,17,509,DAR ES SALAAM
6,1,4,1025,735,125,34,3660,5579,DAR ES SALAAM
4,1,4,401,350,185,144,7,1087,DAR ES SALAAM
6,1,4,211,164,77,38,584,1074,DAR ES SALAAM
6,1,4,39,23,71,6,0,139,DAR ES SALAAM
6,1,4,31,5,4,4,8,52,DAR ES SALAAM
6,1,4,67,13,5,13,12,110,DAR ES SALAAM
6,1,4,204,311,98,52,2,667,DAR ES SALAAM
2,1,4,786,334,81,24,2730,3955,DAR ES SALAAM
4,1,4,143,189,110,55,24,521,DAR ES SALAAM
4,1,4,141,169,87,106,8,511,DAR ES SALAAM
6,1,4,201,183,155,34,0,573,DAR ES SALAAM
6,1,4,143,127,216,265,0,751,DAR ES SALAAM
4,1,4,420,403,21,79,478,1401,DAR ES SALAAM
6,1,4,153,140,66,6,3,368,DAR ES SALAAM
4,1,4,327,256,11,2,174,770,DAR ES SALAAM
6,1,4,83,25,65,3,1,177,DAR ES SALAAM
3,1,4,88,56,50,8,22,224,DAR ES SALAAM
4,1,4,429,510,321,0,478,1738,DAR ES SALAAM
3,1,4,77,37,25,37,7,183,DAR ES SALAAM
6,1,4,25,34,78,77,0,214,DAR ES SALAAM
6,1,4,33,11,2,0,2,48,DAR ES SALAAM
6,1,4,6,6,0,0,0,12,DAR ES SALAAM
6,1,4,13,19,10,87,0,129,DAR ES SALAAM
6,1,4,4,4,0,0,22,30,DAR ES SALAAM
6,1,4,70,83,30,38,200,421,DAR ES SALAAM
2,1,4,1001,1089,610,19,6896,9615,DAR ES SALAAM
5,1,4,864,582,289,162,19,1916,DAR ES SALAAM
4,1,4,415,372,180,87,1261,2315,DAR ES SALAAM
6,1,4,385,302,162,43,2448,3340,DAR ES SALAAM
3,1,4,173,212,55,20,163,623,DAR ES SALAAM
1,1,4,167,70,0,0,418,655,DAR ES SALAAM
3,1,5,4,28,16,425,28,501,GEITA
1,1,5,16,48,2,367,59,492,GEITA
1,1,5,5,58,39,601,91,794,GEITA
3,1,5,3,18,5,386,27,439,GEITA
1,1,5,15,23,21,595,38,692,GEITA
2,1,5,35,25,27,27,90,204,GEITA
1,1,5,14,51,29,27,96,217,GEITA
1,1,5,78,126,74,85,106,469,GEITA
3,1,5,17,56,11,49,97,230,GEITA
5,1,5,54,127,78,29,134,422,GEITA
1,1,5,62,164,21,57,218,522,GEITA
5,1,5,83,159,35,34,91,402,GEITA
1,1,5,82,202,46,40,181,551,GEITA
1,1,5,118,211,28,61,267,685,GEITA
5,1,5,46,62,27,59,191,385,GEITA
4,1,5,21,44,8,32,72,177,GEITA
2,1,5,18,59,12,42,180,311,GEITA
3,1,5,8,29,10,13,41,101,GEITA
1,1,5,1,18,2,9,35,65,GEITA
2,1,5,3,20,43,8,40,114,GEITA
1,1,5,8,21,4,16,41,90,GEITA
3,1,5,1,10,7,18,39,75,GEITA
1,1,5,13,9,11,35,41,109,GEITA
1,1,5,8,21,2,17,42,90,GEITA
5,1,5,0,3,1,1,0,5,GEITA
1,1,5,0,0,0,4,0,4,GEITA
1,1,5,99,61,26,2,1,189,GEITA
1,1,5,132,62,27,0,2,223,GEITA
1,1,5,16,27,7,1,2,53,GEITA
5,1,5,7,4,26,5,4,46,GEITA
1,1,5,8,8,8,14,27,65,GEITA
1,1,5,5,14,6,5,12,42,GEITA
4,1,5,3,15,3,3,4,28,GEITA
3,1,5,5,8,11,1,8,33,GEITA
1,1,5,14,9,14,6,5,48,GEITA
1,1,5,10,18,30,9,15,82,GEITA
1,1,5,11,11,18,4,12,56,GEITA
1,1,5,4,8,9,9,5,35,GEITA
1,1,5,21,77,60,9,43,210,GEITA
5,1,5,20,94,15,6,46,181,GEITA
4,1,5,14,159,5,12,73,263,GEITA
3,1,5,1,2,4,18,3,28,GEITA
1,1,5,4,11,0,0,7,22,GEITA
2,1,5,3,0,0,0,0,3,GEITA
1,1,5,12,3,0,0,0,15,GEITA
2,1,5,65,50,14,6,0,135,GEITA
1,1,5,76,25,30,12,0,143,GEITA
5,1,5,3,0,0,0,0,3,GEITA
1,1,5,7,8,1,0,0,16,GEITA
1,1,5,9,6,0,0,0,15,GEITA
5,1,5,8,3,0,0,0,11,GEITA
3,1,5,24,8,3,1,8,44,GEITA
1,1,5,12,19,1,1,11,44,GEITA
4,1,5,10,14,1,0,20,45,GEITA
2,1,5,17,5,9,3,6,40,GEITA
4,1,5,2,10,0,0,10,22,GEITA
6,1,5,0,2,2,2,0,6,GEITA
1,1,5,0,14,15,18,21,68,GEITA
1,1,5,5,18,10,33,16,82,GEITA
1,1,5,9,18,5,34,29,95,GEITA
5,1,5,0,15,9,21,3,48,GEITA
1,1,5,20,12,4,35,36,107,GEITA
1,1,5,7,20,44,60,18,149,GEITA
1,1,5,11,5,7,26,6,55,GEITA
3,1,5,0,6,2,4,0,12,GEITA
2,1,5,0,7,0,2,0,9,GEITA
4,1,5,3,9,5,2,12,31,GEITA
5,1,5,7,7,6,0,0,20,GEITA
5,1,5,6,10,5,0,0,21,GEITA
3,1,5,33,14,6,7,1,61,GEITA
3,1,5,0,0,0,0,0,0,GEITA
3,1,5,0,0,1,0,0,1,GEITA
4,1,5,0,0,0,0,0,0,GEITA
4,1,5,1,8,1,0,10,20,GEITA
4,1,5,4,7,0,0,0,11,GEITA
4,1,5,0,1,0,0,0,1,GEITA
2,1,6,36,70,67,588,128,889,IRINGA
5,1,6,111,175,128,691,122,1227,IRINGA
2,1,6,110,206,106,723,140,1285,IRINGA
5,1,6,57,75,139,790,148,1209,IRINGA
5,1,6,273,134,143,698,150,1398,IRINGA
1,1,6,82,126,47,724,200,1179,IRINGA
2,1,6,28,83,89,613,149,962,IRINGA
5,1,6,68,65,121,675,187,1116,IRINGA
1,1,6,31,59,20,694,116,920,NJOMBE
5,1,6,10,19,36,82,38,185,IRINGA
2,1,6,116,83,21,107,47,374,IRINGA
5,1,6,117,60,36,127,45,385,IRINGA
3,1,6,6,13,8,45,33,105,IRINGA
2,1,6,19,9,3,35,16,82,IRINGA
5,1,6,8,37,30,113,45,233,IRINGA
5,1,6,38,23,32,120,39,252,NJOMBE
5,1,5,53,43,1,0,11,108,IRINGA
2,1,5,75,16,36,51,11,189,IRINGA
5,1,5,78,18,12,19,6,133,IRINGA
3,1,5,45,104,114,9,2,274,IRINGA
2,1,5,78,25,3,0,13,119,IRINGA
3,1,5,24,32,0,0,9,65,IRINGA
3,1,5,27,30,3,4,6,70,IRINGA
2,1,5,21,9,0,0,5,35,IRINGA
5,1,5,15,38,0,0,7,60,IRINGA
2,1,5,35,7,1,0,0,43,IRINGA
5,1,5,6,3,7,2,4,22,IRINGA
5,1,5,3,6,6,2,6,23,IRINGA
5,1,5,22,18,33,9,3,85,IRINGA
2,1,5,30,42,41,8,16,137,IRINGA
5,1,5,8,34,10,6,20,78,IRINGA
5,1,5,1,6,5,20,0,32,IRINGA
5,1,5,43,24,3,5,1,76,IRINGA
2,1,7,10,24,37,474,34,579,KAGERA
2,1,7,12,10,466,65,0,553,KAGERA
2,1,7,3,14,8,349,7,381,KAGERA
1,1,7,2,11,3,323,14,353,KAGERA
2,1,7,3,7,11,304,3,328,KAGERA
3,1,7,22,32,31,58,8,151,KAGERA
4,1,7,131,213,51,32,61,488,KAGERA
4,1,7,138,191,54,48,74,505,KAGERA
2,1,7,54,96,12,114,55,331,KAGERA
4,1,7,0,0,0,0,0,0,KAGERA
4,1,7,19,68,4,83,39,213,KAGERA
4,1,7,7,17,10,60,20,114,KAGERA
2,1,7,13,0,2,3,11,29,KAGERA
4,1,7,3,32,0,31,16,82,KAGERA
4,1,7,10,14,5,35,25,89,KAGERA
4,1,7,3,13,5,146,13,180,KAGERA
4,1,7,17,23,2,112,14,168,KAGERA
2,1,7,10,23,8,9,10,60,KAGERA
5,1,7,42,38,0,4,5,89,KAGERA
4,1,7,27,28,0,8,1,64,KAGERA
4,1,7,18,6,0,0,0,24,KAGERA
2,1,7,86,59,63,24,9,241,KAGERA
4,1,7,14,8,3,25,0,50,KAGERA
4,1,7,40,15,0,0,0,55,KAGERA
3,1,7,25,21,0,0,4,50,KAGERA
3,1,7,97,43,0,2,12,154,KAGERA
4,1,7,9,8,6,4,0,27,KAGERA
3,1,7,6,13,0,0,0,19,KAGERA
4,1,7,11,34,10,69,28,152,KAGERA
1,1,7,0,8,0,0,0,8,KAGERA
4,1,7,2,0,0,0,0,2,KAGERA
4,1,7,7,7,0,0,0,14,KAGERA
4,1,7,9,26,2,0,0,37,KAGERA
4,1,7,36,9,0,1,2,48,KAGERA
4,1,7,36,28,1,3,2,70,KAGERA
4,1,7,20,3,0,0,0,23,KAGERA
4,1,7,11,6,1,0,1,19,KAGERA
4,1,7,6,20,5,12,22,65,KAGERA
4,1,7,0,14,3,0,0,17,KAGERA
2,1,7,0,0,0,0,0,0,KAGERA
4,1,7,13,19,0,0,2,34,KAGERA
2,1,7,12,4,0,0,3,19,KAGERA
4,1,7,1,9,5,0,0,15,KAGERA
4,1,7,12,4,0,0,0,16,KAGERA
2,1,7,12,13,2,0,0,27,KAGERA
2,1,7,4,1,0,0,0,5,KAGERA
4,1,7,0,0,0,0,0,0,KAGERA
4,1,7,21,2,1,0,0,24,KAGERA
3,1,7,2,0,0,0,0,2,KAGERA
4,1,7,1,11,1,0,0,13,KAGERA
4,1,7,11,0,0,0,0,11,KAGERA
4,1,7,6,9,3,0,10,28,KAGERA
4,1,7,22,0,0,0,0,22,KAGERA
4,1,7,2,0,0,0,0,2,KAGERA
4,1,7,0,25,0,0,0,25,KAGERA
4,1,7,0,25,0,0,0,25,KAGERA
4,1,7,82,33,6,0,1,122,KAGERA
4,1,7,5,14,11,0,4,34,KAGERA
4,1,7,25,4,0,0,0,29,KAGERA
4,1,7,2,2,4,0,5,13,KAGERA
4,1,7,6,6,1,0,0,13,KAGERA
1,1,7,1,0,0,0,0,1,KAGERA
1,1,7,4,2,3,2,2,13,KAGERA
5,1,8,0,16,2,15,8,41,KIGOMA
3,1,8,16,30,13,18,15,92,KIGOMA
5,1,8,12,62,17,14,17,122,KIGOMA
5,1,8,43,61,23,28,17,172,KIGOMA
5,1,8,25,44,32,7,18,126,KIGOMA
3,1,8,13,75,12,21,20,141,KIGOMA
5,1,8,78,53,43,23,20,217,KIGOMA
3,1,8,192,91,51,42,34,410,KIGOMA
5,1,8,2,12,1,18,18,51,KIGOMA
5,1,8,4,7,10,30,21,72,KIGOMA
5,1,8,2,17,3,6,16,44,KIGOMA
5,1,8,9,5,3,15,18,50,KIGOMA
5,1,8,12,62,25,23,36,158,KIGOMA
3,1,8,11,15,5,5,6,42,KIGOMA
5,1,8,15,10,9,11,32,77,KIGOMA
5,1,8,13,16,7,22,23,81,KIGOMA
5,1,8,17,30,2,1,4,54,KIGOMA
5,1,8,34,26,0,5,0,65,KIGOMA
5,1,8,121,62,7,21,42,253,KIGOMA
5,1,8,179,120,28,19,55,401,KIGOMA
5,1,8,34,33,5,0,4,76,KIGOMA
5,1,8,14,25,5,2,7,53,KIGOMA
5,1,8,2,2,0,2,2,8,KIGOMA
5,1,8,9,7,0,3,0,19,KIGOMA
5,1,8,17,20,3,6,0,46,KIGOMA
1,1,8,40,1,6,1,0,48,KIGOMA
1,1,8,1,5,1,0,2,9,KIGOMA
3,1,8,3,1,0,0,0,4,KIGOMA
5,1,8,2,0,0,0,8,10,KIGOMA
1,1,8,8,1,0,0,0,9,KIGOMA
3,1,8,4,4,1,0,0,9,KIGOMA
3,1,8,0,3,4,2,0,9,KIGOMA
5,1,8,6,2,0,0,5,13,KIGOMA
5,1,8,81,68,46,7,10,212,KIGOMA
5,1,8,17,39,23,4,8,91,KIGOMA
5,1,8,6,7,1,4,0,18,KIGOMA
5,1,8,15,0,0,0,0,15,KIGOMA
5,1,8,26,12,0,0,0,38,KIGOMA
5,1,8,6,3,0,0,0,9,KIGOMA
5,1,8,9,3,0,0,6,18,KIGOMA
3,1,8,3,7,1,18,24,53,KIGOMA
5,1,8,1,1,0,0,0,2,KIGOMA
5,1,8,4,10,0,0,6,20,KIGOMA
1,1,8,0,1,0,0,0,1,KIGOMA
3,1,8,0,1,0,0,0,1,KIGOMA
3,1,8,0,1,0,0,0,1,KIGOMA
3,1,8,1,2,0,0,0,3,KIGOMA
3,1,8,0,1,0,0,0,1,KIGOMA
3,1,8,2,5,1,0,0,8,KIGOMA
3,1,8,3,1,2,0,0,6,KIGOMA
3,1,8,3,3,0,0,0,6,KIGOMA
3,1,8,0,0,0,0,0,0,KIGOMA
5,1,9,202,87,63,228,224,804,KILIMANJARO
4,1,9,73,174,41,81,28,397,KILIMANJARO
4,1,9,17,36,11,40,2,106,KILIMANJARO
4,1,9,1,9,3,0,0,13,KILIMANJARO
1,1,9,6,10,6,0,3,25,KILIMANJARO
5,1,9,53,36,6,6,0,101,KILIMANJARO
5,1,9,4,13,3,1,0,21,KILIMANJARO
2,1,9,7,12,0,0,0,19,KILIMANJARO
1,1,9,25,46,4,1,0,76,KILIMANJARO
1,1,9,12,6,0,0,0,18,KILIMANJARO
2,1,9,23,74,31,6,1,135,KILIMANJARO
3,1,9,16,49,0,0,0,65,KILIMANJARO
2,1,9,4,14,1,0,0,19,KILIMANJARO
6,1,9,10,23,0,0,2,35,KILIMANJARO
3,1,9,2,0,0,1,2,5,KILIMANJARO
5,1,9,3,5,3,4,3,18,KILIMANJARO
4,1,9,4,3,0,0,1,8,KILIMANJARO
4,1,9,5,53,8,0,2,68,KILIMANJARO
3,1,9,23,43,4,3,10,83,KILIMANJARO
4,1,9,5,3,1,0,12,21,KILIMANJARO
2,1,9,0,1,0,4,0,5,KILIMANJARO
2,1,9,2,0,0,0,0,2,KILIMANJARO
5,1,9,9,3,1,0,3,16,KILIMANJARO
2,1,10,1,17,7,20,32,77,KATAVI
1,1,10,58,34,26,10,9,137,KATAVI
4,1,10,7,9,28,3,8,55,KATAVI
7,1,10,2,4,0,8,6,20,KATAVI
4,1,10,18,24,11,20,23,96,KATAVI
3,1,10,0,23,2,17,12,54,KATAVI
5,1,10,10,53,9,21,22,115,KATAVI
6,1,10,1,0,0,0,1,2,KATAVI
6,1,10,0,0,0,0,5,5,KATAVI
1,1,10,0,5,1,6,2,14,KATAVI
7,1,10,14,6,1,11,21,53,KATAVI
6,1,10,2,7,1,4,13,27,KATAVI
3,1,10,4,12,4,1,8,29,KATAVI
4,1,10,16,0,0,0,0,16,KATAVI
2,1,10,0,2,1,0,0,3,KATAVI
1,1,10,4,1,101,0,1,107,KATAVI
1,1,10,3,15,4,0,1,23,KATAVI
6,1,10,2,1,0,0,4,7,KATAVI
3,1,10,17,66,5,0,2,90,KATAVI
1,1,10,16,13,5,4,5,43,KATAVI
3,1,10,16,13,5,4,5,43,KATAVI
3,1,11,152,204,292,360,105,1113,LINDI
2,1,11,235,270,325,290,145,1265,LINDI
3,1,11,144,210,280,340,95,1069,LINDI
2,1,11,161,334,250,230,109,1084,LINDI
3,1,11,132,204,261,310,84,991,LINDI
4,1,11,134,224,260,271,120,1009,LINDI
1,1,11,30,70,80,120,102,402,LINDI
4,1,11,212,204,255,260,98,1029,LINDI
7,1,11,30,52,116,56,116,370,LINDI
4,1,11,112,182,241,253,81,869,LINDI
1,1,11,12,7,1,2,6,28,LINDI
2,1,11,30,35,34,23,12,134,LINDI
2,1,11,46,30,45,17,20,158,LINDI
2,1,11,30,35,34,23,12,134,LINDI
1,1,11,18,26,12,14,6,76,LINDI
3,1,11,28,50,20,15,16,129,LINDI
5,1,11,56,62,16,6,8,148,LINDI
5,1,11,48,30,14,10,22,124,LINDI
5,1,11,28,24,10,6,20,88,LINDI
5,1,11,34,21,12,6,14,87,LINDI
2,1,11,66,49,25,49,35,224,LINDI
5,1,11,18,31,8,6,12,75,LINDI
5,1,11,18,31,8,6,4,67,LINDI
5,1,11,7,18,4,2,4,35,LINDI
5,1,11,5,13,2,2,2,24,LINDI
5,1,11,34,32,10,8,20,104,LINDI
3,1,11,30,15,18,8,6,77,LINDI
5,1,11,32,28,10,8,20,98,LINDI
3,1,11,52,42,27,29,6,156,LINDI
3,1,11,36,24,17,9,8,94,LINDI
5,1,11,20,12,6,2,2,42,LINDI
1,1,11,9,3,4,2,0,18,LINDI
1,1,11,9,2,4,4,2,21,LINDI
3,1,11,22,6,11,2,0,41,LINDI
4,1,11,30,23,93,8,1,155,LINDI
4,1,11,25,26,8,10,0,69,LINDI
2,1,11,68,95,38,54,48,303,LINDI
5,1,11,30,31,5,8,2,76,LINDI
4,1,12,34,62,24,59,150,329,MARA
4,1,12,15,26,22,28,150,241,MARA
3,1,12,8,54,35,41,132,270,MARA
4,1,12,15,23,27,40,65,170,MARA
4,1,12,27,53,2,19,111,212,MARA
3,1,12,0,25,18,12,0,55,MARA
4,1,12,8,32,22,17,44,123,MARA
4,1,12,19,98,31,20,52,220,MARA
4,1,12,2,1,0,0,0,3,MARA
3,1,12,3,5,10,3,2,23,MARA
3,1,12,5,3,11,4,35,58,MARA
3,1,12,1,17,4,2,9,33,MARA
4,1,12,15,17,23,9,19,83,MARA
3,1,12,24,54,34,1,6,119,MARA
2,1,12,0,0,0,0,0,0,MARA
2,1,12,16,6,2,12,5,41,MARA
2,1,12,2,3,0,5,0,10,MARA
4,1,12,2,16,13,4,1,36,MARA
3,1,12,4,1,0,1,0,6,MARA
4,1,12,4,3,0,0,3,10,MARA
3,1,12,0,5,4,0,0,9,MARA
4,1,12,6,7,7,1,6,27,MARA
2,1,12,1,1,0,0,2,4,MARA
2,1,12,4,3,0,1,1,9,MARA
2,1,12,0,0,0,0,0,0,MARA
4,1,12,2,21,0,3,22,48,MARA
4,1,12,6,4,1,0,0,11,MARA
5,1,12,5,3,0,0,0,8,MARA
2,1,12,5,5,0,0,0,10,MARA
3,1,12,4,11,1,3,6,25,MARA
3,1,12,19,34,12,15,56,136,MARA
3,1,12,35,114,37,8,49,243,MARA
4,1,12,16,26,1,0,10,53,MARA
3,1,12,8,12,3,3,0,26,MARA
3,1,12,0,3,1,0,1,5,MARA
4,1,12,1,10,0,0,0,11,MARA
3,1,12,2,0,0,1,0,3,MARA
2,1,12,2,13,0,0,0,15,MARA
2,1,12,1,28,6,0,0,35,MARA
3,1,12,4,4,0,0,0,8,MARA
3,1,12,7,22,3,1,3,36,MARA
7,1,13,20,48,59,603,176,906,MBEYA
6,1,13,73,177,89,708,170,1217,MBEYA
1,1,13,287,515,130,762,131,1825,MBEYA
5,1,13,115,222,53,461,97,948,MBEYA
5,1,13,73,143,27,12,25,280,MBEYA
2,1,13,10,44,0,15,33,102,MBEYA
6,1,13,5,7,25,3,16,56,MBEYA
6,1,13,10,33,10,3,18,74,MBEYA
7,1,13,4,9,4,1,7,25,MBEYA
6,1,13,1,10,8,1,13,33,MBEYA
7,1,13,62,101,22,104,32,321,MBEYA
2,1,13,78,130,42,62,19,331,MBEYA
1,1,13,93,128,103,58,16,398,MBEYA
2,1,13,46,57,32,56,8,199,MBEYA
6,1,13,18,43,18,48,0,127,MBEYA
2,1,13,24,28,14,14,12,92,MBEYA
2,1,13,44,75,4,12,7,142,MBEYA
2,1,13,29,7,1,0,0,37,MBEYA
1,1,13,0,6,0,0,0,6,MBEYA
7,1,13,14,45,3,3,26,91,MBEYA
7,1,13,15,43,2,0,12,72,MBEYA
1,1,13,23,43,8,1,0,75,MBEYA
1,1,13,22,11,6,0,2,41,MBEYA
1,1,13,10,5,0,0,0,15,MBEYA
6,1,13,18,25,7,18,53,121,MBEYA
6,1,13,13,20,7,21,29,90,MBEYA
6,1,13,3,16,3,0,7,29,MBEYA
2,1,13,2,2,0,0,0,4,MBEYA
3,1,13,2,3,0,0,0,5,MBEYA
1,1,13,30,24,2,0,4,60,MBEYA
1,1,13,4,25,1,0,4,34,MBEYA
3,1,13,12,7,4,0,1,24,MBEYA
7,1,13,1,2,3,0,0,6,MBEYA
1,1,13,25,33,1,4,12,75,MBEYA
2,1,13,8,48,6,2,4,68,MBEYA
1,1,13,0,2,0,0,0,2,MBEYA
6,1,13,16,7,0,0,0,23,MBEYA
6,1,13,12,10,2,5,2,31,MBEYA
1,1,13,24,30,1,0,0,55,MBEYA
4,1,13,7,3,0,0,0,10,MBEYA
5,1,13,13,4,0,0,0,17,MBEYA
7,1,13,6,59,5,0,8,78,MBEYA
7,1,13,22,4,0,0,0,26,MBEYA
2,1,13,28,7,0,0,0,35,MBEYA
1,1,14,14,69,1,18,38,140,MANYARA
1,1,14,17,33,10,32,44,136,MANYARA
1,1,14,26,48,22,71,120,287,MANYARA
2,1,14,21,26,15,59,125,246,MANYARA
4,1,14,7,30,21,104,119,281,MANYARA
5,1,14,5,50,32,123,106,316,MANYARA
3,1,14,9,29,15,67,69,189,MANYARA
5,1,14,11,45,14,79,81,230,MANYARA
1,1,14,13,41,15,24,99,192,MANYARA
2,1,14,7,38,21,56,84,206,MANYARA
5,1,14,7,29,3,0,23,62,MANYARA
3,1,14,6,15,4,0,22,47,MANYARA
3,1,14,3,11,3,1,16,34,MANYARA
7,1,14,1,3,10,2,6,22,MANYARA
7,1,14,3,9,90,3,7,112,MANYARA
3,1,14,0,4,0,1,4,9,MANYARA
7,1,14,2,4,2,3,2,13,MANYARA
1,1,14,0,14,1,0,0,15,MANYARA
5,1,14,0,0,0,0,0,0,MANYARA
4,1,14,12,12,1,2,32,59,MANYARA
6,1,14,1,16,2,6,7,32,MANYARA
4,1,14,11,25,1,0,0,37,MANYARA
2,1,14,5,52,3,2,3,65,MANYARA
4,1,14,0,0,1,0,0,1,MANYARA
2,1,14,2,7,2,0,2,13,MANYARA
3,1,14,6,22,0,10,0,38,MANYARA
6,1,14,1,3,1,0,3,8,MANYARA
2,1,14,0,5,0,0,2,7,MANYARA
3,1,14,4,6,1,1,4,16,MANYARA
6,1,14,2,10,3,1,10,26,MANYARA
1,1,14,2,4,2,1,5,14,MANYARA
1,1,14,1,6,5,10,19,41,MANYARA
6,1,14,3,6,3,0,5,17,MANYARA
4,1,15,123,153,426,710,428,1840,MOROGORO
3,1,15,62,144,81,1273,465,2025,MOROGORO
5,1,15,130,206,196,1365,383,2280,MOROGORO
6,1,15,104,235,118,615,123,1195,MOROGORO
5,1,15,73,74,73,617,125,962,MOROGORO
4,1,15,25,71,70,583,175,924,MOROGORO
2,1,15,21,41,56,572,159,849,MOROGORO
6,1,15,25,70,82,495,143,815,MOROGORO
6,1,15,108,131,200,452,181,1072,MOROGORO
6,1,15,55,83,83,666,192,1079,MOROGORO
5,1,15,90,109,52,770,188,1209,MOROGORO
6,1,15,30,58,78,838,195,1199,MOROGORO
5,1,15,37,34,4,28,61,164,MOROGORO
2,1,15,12,20,6,2,6,46,MOROGORO
1,1,15,8,51,58,24,62,203,MOROGORO
6,1,15,67,201,189,930,239,1626,MOROGORO
4,1,15,9,64,7,28,60,168,MOROGORO
2,1,15,16,43,21,2,48,130,MOROGORO
5,1,15,7,8,2,0,9,26,MOROGORO
7,1,15,9,17,13,30,26,95,MOROGORO
5,1,15,7,9,3,0,8,27,MOROGORO
6,1,15,6,7,2,3,1,19,MOROGORO
5,1,15,60,85,12,3,27,187,MOROGORO
6,1,15,112,145,29,6,45,337,MOROGORO
2,1,15,7,34,46,0,11,98,MOROGORO
7,1,15,16,25,2,1,14,58,MOROGORO
7,1,15,74,30,38,18,22,182,MOROGORO
5,1,15,15,19,1,20,45,100,MOROGORO
4,1,15,50,32,130,6,18,236,MOROGORO
6,1,15,0,16,9,1,6,32,MOROGORO
6,1,15,3,5,0,0,0,8,MOROGORO
7,1,15,0,2,0,0,0,2,MOROGORO
6,1,15,8,17,0,0,0,25,MOROGORO
6,1,15,9,12,2,8,9,40,MOROGORO
2,1,15,16,43,21,2,48,130,MOROGORO
1,1,15,19,42,85,3,20,169,MOROGORO
5,1,15,4,9,1,0,10,24,MOROGORO
7,1,15,17,7,4,0,0,28,MOROGORO
3,1,15,3,8,1,0,0,12,MOROGORO
4,1,15,9,16,0,0,5,30,MOROGORO
2,1,15,0,16,9,1,6,32,MOROGORO
4,1,15,1,23,2,3,9,38,MOROGORO
6,1,15,40,1,0,0,0,41,MOROGORO
7,1,15,3,40,0,0,14,57,MOROGORO
5,1,15,0,35,0,0,0,35,MOROGORO
6,1,15,1,0,1,0,6,8,MOROGORO
5,1,15,48,29,8,5,7,97,MOROGORO
7,1,15,14,15,16,6,0,51,MOROGORO
6,1,15,26,31,6,6,6,75,MOROGORO
4,1,15,41,41,10,2,145,239,MOROGORO
1,1,15,14,20,2,0,1,37,MOROGORO
1,1,15,17,10,1,0,1,29,MOROGORO
6,1,15,5,3,3,1,2,14,MOROGORO
5,1,15,0,28,3,0,0,31,MOROGORO
2,1,15,162,224,6,6,506,904,MOROGORO
4,1,15,3,12,10,1,18,44,MOROGORO
1,1,15,17,10,1,0,1,29,MOROGORO
1,1,16,93,49,25,13,8,188,MTWARA
1,1,16,76,81,87,24,77,345,MTWARA
3,1,16,75,83,160,30,84,432,MTWARA
7,1,16,48,55,152,169,65,489,MTWARA
1,1,16,28,21,20,252,44,365,MTWARA
3,1,16,20,34,18,107,42,221,MTWARA
1,1,16,11,28,60,12,39,150,MTWARA
5,1,16,22,17,23,54,38,154,MTWARA
3,1,16,12,31,17,95,61,216,MTWARA
5,1,16,10,16,21,50,37,134,MTWARA
7,1,16,10,40,31,81,40,202,MTWARA
3,1,16,15,25,18,97,40,195,MTWARA
5,1,16,7,7,6,58,34,112,MTWARA
7,1,16,0,1,3,2,4,10,MTWARA
5,1,16,0,1,2,1,2,6,MTWARA
4,1,16,3,3,8,0,17,31,MTWARA
7,1,16,15,12,13,8,34,82,MTWARA
3,1,16,9,15,0,9,3,36,MTWARA
1,1,16,13,19,7,4,30,73,MTWARA
5,1,16,39,13,19,28,30,129,MTWARA
4,1,16,11,21,20,42,40,134,MTWARA
4,1,16,10,18,4,7,36,75,MTWARA
5,1,16,5,3,5,3,13,29,MTWARA
5,1,16,0,1,0,34,3,38,MTWARA
4,1,16,0,3,4,0,4,11,MTWARA
4,1,16,5,0,0,30,5,40,MTWARA
4,1,16,18,13,4,5,20,60,MTWARA
1,1,16,0,10,0,0,3,13,MTWARA
1,1,16,2,3,0,0,2,7,MTWARA
2,1,16,10,1,3,0,0,14,MTWARA
6,1,16,4,8,8,20,34,74,MTWARA
2,1,16,4,12,9,15,52,92,MTWARA
2,1,16,24,16,5,3,38,86,MTWARA
1,1,16,11,13,19,16,32,91,MTWARA
6,1,16,5,18,8,23,36,90,MTWARA
1,1,16,34,24,25,30,39,152,MTWARA
6,1,16,32,17,43,55,35,182,MTWARA
2,1,16,0,1,0,0,1,2,MTWARA
2,1,16,0,0,0,26,0,26,MTWARA
1,1,16,2,1,0,0,1,4,MTWARA
3,1,16,27,9,29,0,0,65,MTWARA
2,1,16,0,0,0,0,0,0,MTWARA
1,1,16,3,6,1,0,0,10,MTWARA
1,1,16,3,2,3,2,2,12,MTWARA
5,1,17,16,44,8,41,60,169,MWANZA
2,1,17,42,75,27,52,60,256,MWANZA
3,1,17,61,243,74,155,186,719,MWANZA
5,1,17,34,104,22,55,171,386,MWANZA
3,1,17,32,47,11,65,156,311,MWANZA
3,1,17,57,32,33,27,213,362,MWANZA
2,1,17,38,47,42,145,152,424,MWANZA
5,1,17,21,21,38,192,111,383,MWANZA
5,1,17,72,95,41,211,195,614,MWANZA
3,1,17,96,113,99,129,106,543,MWANZA
3,1,17,31,24,12,58,4,129,MWANZA
3,1,17,3,10,0,1,1,15,MWANZA
3,1,17,0,3,0,1,0,4,MWANZA
2,1,17,1,9,6,2,0,18,MWANZA
5,1,17,5,18,1,5,9,38,MWANZA
3,1,17,4,11,1,5,13,34,MWANZA
3,1,17,7,24,0,3,1,35,MWANZA
3,1,17,8,7,2,0,1,18,MWANZA
5,1,17,1,25,6,0,3,35,MWANZA
3,1,17,3,24,4,0,1,32,MWANZA
5,1,17,25,22,11,0,52,110,MWANZA
5,1,17,26,23,8,12,19,88,MWANZA
3,1,17,10,24,6,5,16,61,MWANZA
2,1,17,3,19,7,2,3,34,MWANZA
5,1,17,2,10,3,0,6,21,GEITA
5,1,17,8,12,13,6,3,42,MWANZA
3,1,17,5,24,4,8,16,57,MWANZA
3,1,17,64,66,68,20,24,242,MWANZA
3,1,17,221,167,66,62,38,554,MWANZA
5,1,17,1,2,0,0,6,9,MWANZA
5,1,17,3,5,0,0,0,8,MWANZA
2,1,17,4,4,3,2,11,24,MWANZA
5,1,17,15,14,11,7,2,49,MWANZA
5,1,17,2,4,2,1,1,10,MWANZA
5,1,17,11,14,14,11,4,54,MWANZA
5,1,17,3,8,4,0,2,17,MWANZA
2,1,17,0,4,1,0,9,14,MWANZA
2,1,17,10,11,2,0,0,23,MWANZA
3,1,17,15,13,1,2,7,38,MWANZA
2,1,17,11,13,16,0,25,65,MWANZA
2,1,17,1,2,0,0,7,10,MWANZA
2,1,17,13,10,0,0,0,23,MWANZA
2,1,17,1,7,1,0,0,9,MWANZA
2,1,17,3,68,52,3,3,129,MWANZA
2,1,17,1,6,1,2,3,13,MWANZA
2,1,17,4,10,0,4,2,20,MWANZA
2,1,17,3,1,2,0,0,6,MWANZA
2,1,17,2,4,0,0,0,6,MWANZA
5,1,6,26,82,12,840,88,1048,NJOMBE
4,1,6,112,96,101,679,119,1107,NJOMBE
3,1,6,42,25,11,114,52,244,NJOMBE
5,1,6,85,63,38,95,51,332,NJOMBE
3,1,6,100,126,124,165,120,635,NJOMBE
5,1,6,17,38,35,13,2,105,NJOMBE
4,1,6,5,9,5,2,1,22,NJOMBE
3,1,6,8,14,6,1,3,32,NJOMBE
1,1,6,20,7,1,0,2,30,NJOMBE
1,1,6,25,19,10,0,0,54,NJOMBE
5,1,6,4,10,0,0,0,14,NJOMBE
2,1,6,2,2,0,2,4,10,NJOMBE
3,1,6,11,5,0,0,0,16,NJOMBE
1,1,6,25,7,7,0,3,42,NJOMBE
2,1,6,5,10,0,0,2,17,NJOMBE
5,1,6,5,11,7,0,1,24,NJOMBE
1,1,6,22,20,31,10,16,99,NJOMBE
1,1,6,9,14,13,9,7,52,NJOMBE
3,1,6,71,48,34,10,8,171,NJOMBE
2,1,6,10,6,3,2,0,21,NJOMBE
4,1,6,2,7,0,0,0,9,NJOMBE
5,1,6,19,8,1,1,1,30,NJOMBE
4,1,6,6,2,2,2,2,14,NJOMBE
1,1,6,31,13,1,3,2,50,NJOMBE
3,1,6,3,3,23,0,0,29,NJOMBE
3,1,6,31,52,45,18,13,159,NJOMBE
3,1,6,36,20,25,4,1,86,NJOMBE
5,1,6,16,0,7,3,8,34,NJOMBE
5,1,6,5,1,4,2,0,12,NJOMBE
4,1,6,6,2,2,0,0,10,NJOMBE
4,1,6,48,56,24,5,2,135,NJOMBE
4,1,6,9,8,2,7,1,27,NJOMBE
3,1,6,5,13,10,0,0,28,NJOMBE
4,1,18,3,39,4,17,44,107,RUKWA
4,1,18,5,19,16,17,48,105,RUKWA
1,1,18,1,17,3,28,21,70,RUKWA
4,1,18,17,32,24,74,25,172,RUKWA
4,1,18,6,26,11,29,41,113,RUKWA
1,1,18,0,15,10,32,35,92,RUKWA
4,1,18,99,89,36,42,82,348,RUKWA
4,1,18,27,15,11,29,15,97,RUKWA
4,1,18,9,10,6,44,15,84,RUKWA
5,1,18,3,13,9,15,7,47,RUKWA
3,1,18,4,4,7,19,41,75,RUKWA
7,1,18,3,0,2,13,22,40,RUKWA
7,1,19,1,4,5,13,27,50,KATAVI
5,1,19,1,4,1,2,5,13,KATAVI
7,1,18,5,19,8,10,6,48,RUKWA
7,1,18,2,12,7,13,0,34,RUKWA
4,1,18,24,256,1,0,1,282,RUKWA
1,1,18,2,2,3,1,0,8,RUKWA
4,1,18,6,3,3,10,5,27,RUKWA
4,1,18,3,3,5,5,3,19,RUKWA
2,1,18,6,1,1,3,0,11,RUKWA
1,1,18,0,7,5,0,0,12,RUKWA
3,1,18,4,11,3,0,6,24,RUKWA
4,1,18,0,7,3,1,3,14,RUKWA
3,1,18,0,7,9,0,4,20,RUKWA
4,1,18,3,7,2,0,2,14,RUKWA
4,1,18,0,5,10,0,0,15,RUKWA
4,1,18,0,2,3,0,2,7,RUKWA
7,1,18,0,4,1,9,5,19,RUKWA
5,1,18,0,4,0,1,0,5,RUKWA
3,1,18,1,0,1,1,4,7,RUKWA
6,1,18,3,2,0,0,0,5,RUKWA
5,1,18,0,3,5,1,1,10,RUKWA
3,1,18,1,1,0,0,1,3,RUKWA
5,1,18,4,1,0,0,0,5,RUKWA
7,1,18,1,1,0,0,0,2,RUKWA
2,1,18,3,6,2,0,0,11,RUKWA
4,1,18,0,0,0,0,0,0,RUKWA
2,1,18,1,1,0,4,0,6,RUKWA
1,1,20,8,13,12,104,33,170,RUVUMA
2,1,20,7,21,8,58,26,120,RUVUMA
3,1,20,48,41,30,35,22,176,RUVUMA
3,1,20,48,41,30,35,22,176,RUVUMA
3,1,20,4,7,4,48,25,88,RUVUMA
3,1,20,22,31,2,124,34,213,RUVUMA
3,1,20,6,5,8,51,42,112,RUVUMA
3,1,20,28,9,7,24,17,85,RUVUMA
2,1,20,20,26,11,53,57,167,RUVUMA
2,1,20,57,34,27,107,75,300,RUVUMA
1,1,20,8,10,5,67,44,134,RUVUMA
3,1,20,13,15,17,102,44,191,RUVUMA
1,1,20,66,69,31,126,128,420,RUVUMA
3,1,20,6,17,9,86,27,145,RUVUMA
2,1,20,23,31,6,25,21,106,RUVUMA
1,1,20,29,55,40,15,9,148,RUVUMA
2,1,20,39,33,62,33,13,180,RUVUMA
1,1,20,8,4,4,0,6,22,RUVUMA
1,1,20,8,1,1,0,0,10,RUVUMA
1,1,20,2,0,0,0,2,4,RUVUMA
4,1,20,4,1,0,3,2,10,RUVUMA
3,1,20,7,8,6,0,3,24,RUVUMA
5,1,20,36,31,38,0,3,108,RUVUMA
1,1,20,25,56,1,33,0,115,RUVUMA
2,1,20,6,9,0,0,2,17,RUVUMA
5,1,20,7,0,0,2,6,15,RUVUMA
5,1,20,3,3,0,0,2,8,RUVUMA
5,1,20,3,2,0,1,3,9,RUVUMA
5,1,20,3,8,4,0,4,19,RUVUMA
6,1,20,4,5,11,0,0,20,RUVUMA
1,1,20,3,1,138,78,9,229,RUVUMA
2,1,20,21,19,0,2,1,43,RUVUMA
4,1,20,0,0,1,0,0,1,RUVUMA
1,1,20,11,21,4,3,0,39,RUVUMA
4,1,20,16,12,2,8,2,40,RUVUMA
7,1,20,4,1,0,0,0,5,RUVUMA
2,1,20,10,2,0,0,0,12,RUVUMA
4,1,20,6,11,0,0,1,18,RUVUMA
4,1,20,1,16,6,2,0,25,RUVUMA
2,1,20,5,4,2,1,0,12,RUVUMA
4,1,20,9,1,3,0,2,15,RUVUMA
4,1,20,2,1,0,0,0,3,RUVUMA
5,1,20,0,3,0,0,0,3,RUVUMA
3,1,20,3,2,0,0,0,5,RUVUMA
4,1,20,1,0,14,1,0,16,RUVUMA
3,1,20,29,18,0,12,0,59,RUVUMA
4,1,20,16,12,2,8,2,40,RUVUMA
4,1,20,7,7,0,0,0,14,RUVUMA
6,1,20,0,3,0,0,0,3,RUVUMA
6,1,20,18,22,32,3,6,81,RUVUMA
7,1,20,0,3,0,0,0,3,RUVUMA
2,1,20,32,4,0,0,0,36,RUVUMA
7,1,20,1,1,3,3,0,8,RUVUMA
3,1,20,1,2,1,0,0,4,RUVUMA
4,1,20,0,2,0,0,0,2,RUVUMA
2,1,20,0,3,0,4,8,15,RUVUMA
2,1,20,4,1,1,3,3,12,RUVUMA
6,1,20,6,0,0,0,0,6,RUVUMA
4,1,21,66,64,52,644,96,922,SHINYANGA
2,1,21,73,56,50,524,84,787,SHINYANGA
3,1,21,131,94,156,605,53,1039,SHINYANGA
5,1,21,15,95,30,417,40,597,SHINYANGA
4,1,21,38,58,57,625,120,898,SHINYANGA
2,1,21,39,49,43,220,147,498,SHINYANGA
3,1,21,25,46,41,194,143,449,SHINYANGA
2,1,21,12,47,42,211,132,444,SHINYANGA
2,1,21,20,13,12,169,119,333,SHINYANGA
3,1,21,20,15,25,163,119,342,SHINYANGA
3,1,21,0,3,8,8,8,27,SHINYANGA
2,1,21,2,15,10,12,7,46,SHINYANGA
3,1,21,2,8,8,7,4,29,SHINYANGA
2,1,21,3,12,3,0,0,18,SHINYANGA
2,1,21,2,12,3,0,0,17,SHINYANGA
5,1,21,3,15,10,23,17,68,SHINYANGA
2,1,21,5,12,7,13,36,73,SHINYANGA
5,1,21,70,38,7,40,22,177,SHINYANGA
5,1,21,1,1,2,3,2,9,SHINYANGA
2,1,21,8,6,6,6,60,86,SHINYANGA
5,1,21,36,55,25,16,12,144,SHINYANGA
5,1,21,15,75,6,3,9,108,SHINYANGA
3,1,21,1,12,4,3,8,28,SHINYANGA
2,1,21,0,5,2,4,8,19,SHINYANGA
4,1,21,0,4,3,0,2,9,SHINYANGA
2,1,21,10,7,4,6,6,33,SHINYANGA
4,1,21,0,22,1,3,8,34,SHINYANGA
4,1,21,4,2,3,2,2,13,SHINYANGA
2,1,21,2,1,2,0,3,8,SHINYANGA
3,1,21,1,5,4,0,2,12,SHINYANGA
4,1,21,57,5,4,3,9,78,SHINYANGA
3,1,21,7,27,9,8,0,51,SHINYANGA
4,1,21,7,21,2,3,0,33,SHINYANGA
4,1,21,7,11,5,2,27,52,SHINYANGA
4,1,21,3,9,4,3,12,31,SHINYANGA
3,1,21,0,3,3,0,0,6,SHINYANGA
5,1,21,40,46,4,4,13,107,SHINYANGA
5,1,21,2,5,3,1,0,11,SHINYANGA
2,1,21,11,13,5,3,2,34,SHINYANGA
5,1,21,4,9,3,4,17,37,SHINYANGA
3,1,21,2,15,5,3,13,38,SHINYANGA
5,1,21,3,0,0,0,0,3,SHINYANGA
3,1,21,7,19,7,5,19,57,SHINYANGA
4,1,21,6,11,11,26,40,94,SHINYANGA
3,1,21,2,19,9,47,18,95,SHINYANGA
3,1,21,0,3,8,8,8,27,SHINYANGA
3,1,21,2,6,6,3,6,23,SHINYANGA
2,1,21,2,18,20,12,7,59,SHINYANGA
3,1,21,2,2,3,0,3,10,SHINYANGA
3,1,21,7,27,9,8,0,51,SHINYANGA
2,1,21,0,3,5,3,0,11,SHINYANGA
2,1,21,11,13,5,3,2,34,SHINYANGA
5,1,21,4,9,3,4,17,37,SHINYANGA
3,1,21,1,5,5,3,0,14,SHINYANGA
4,1,21,0,3,1,0,0,4,SHINYANGA
5,1,22,26,33,47,708,125,939,SINGIDA
5,1,22,72,158,53,747,162,1192,SINGIDA
5,1,22,21,21,64,856,111,1073,SINGIDA
5,1,22,22,53,243,406,103,827,SINGIDA
5,1,22,47,27,64,882,100,1120,SINGIDA
5,1,22,294,520,345,1175,276,2610,SINGIDA
5,1,22,72,158,53,747,162,1192,SINGIDA
1,1,22,15,48,0,612,120,795,SINGIDA
5,1,22,0,4,1,1,10,16,SINGIDA
5,1,22,24,44,50,679,104,901,SINGIDA
5,1,22,10,31,12,445,46,544,SINGIDA
1,1,22,7,50,39,514,121,731,SINGIDA
5,1,22,1,8,4,1,12,26,SINGIDA
5,1,22,6,144,17,41,76,284,SINGIDA
5,1,22,105,42,20,63,66,296,SINGIDA
5,1,22,7,40,2,122,61,232,SINGIDA
5,1,22,8,20,6,37,26,97,SINGIDA
5,1,22,6,8,9,37,19,79,SINGIDA
1,1,22,1,5,5,19,16,46,SINGIDA
5,1,22,2,5,0,1,8,16,SINGIDA
5,1,22,0,17,0,0,9,26,SINGIDA
1,1,22,1,9,0,1,15,26,SINGIDA
5,1,22,3,23,3,6,18,53,SINGIDA
5,1,22,4,22,19,0,11,56,SINGIDA
5,1,22,15,4,1,8,6,34,SINGIDA
5,1,22,0,0,0,0,0,0,SINGIDA
5,1,22,9,8,2,1,0,20,SINGIDA
5,1,22,29,52,1,0,0,82,SINGIDA
5,1,22,2,2,0,0,1,5,SINGIDA
5,1,22,4,5,1,0,4,14,SINGIDA
5,1,22,9,9,6,0,6,30,SINGIDA
5,1,22,0,18,1,1,12,32,SINGIDA
5,1,22,1,9,2,0,25,37,SINGIDA
5,1,22,2,9,0,0,12,23,SINGIDA
1,1,22,3,4,5,5,9,26,SINGIDA
5,1,22,0,3,0,0,8,11,SINGIDA
1,1,22,3,8,3,3,7,24,SINGIDA
5,1,22,2,12,0,1,14,29,SINGIDA
1,1,22,2,15,0,2,7,26,SINGIDA
5,1,22,5,6,1,5,9,26,SINGIDA
5,1,22,0,5,0,0,7,12,SINGIDA
5,1,22,14,33,10,26,12,95,SINGIDA
5,1,22,10,12,12,0,3,37,SINGIDA
1,1,22,1,6,2,0,2,11,SINGIDA
5,1,22,32,40,13,0,6,91,SINGIDA
5,1,22,34,59,15,0,6,114,SINGIDA
1,1,22,2,1,3,2,3,11,SINGIDA
5,1,22,2,2,0,0,1,5,SINGIDA
1,1,22,8,3,1,0,2,14,SINGIDA
5,1,22,1,5,0,0,5,11,SINGIDA
5,1,22,4,13,0,0,6,23,SINGIDA
5,1,22,6,18,2,7,7,40,SINGIDA
5,1,22,4,9,0,2,5,20,SINGIDA
5,1,22,0,0,0,0,0,0,SINGIDA
5,1,22,0,1,0,0,0,1,SINGIDA
5,1,22,0,3,9,4,7,23,SINGIDA
5,1,22,0,7,3,7,13,30,SINGIDA
5,1,22,9,12,5,1,6,33,SINGIDA
5,1,22,0,6,4,1,17,28,SINGIDA
5,1,22,0,4,1,1,3,9,SINGIDA
5,1,22,0,6,0,0,2,8,SINGIDA
4,1,23,21,87,67,287,342,804,SIMIYU
2,1,23,6,80,17,36,164,303,SIMIYU
1,1,23,51,129,71,92,301,644,SIMIYU
1,1,23,50,116,65,73,295,599,SIMIYU
1,1,23,6,24,2,6,71,109,SIMIYU
2,1,23,15,26,31,39,94,205,SIMIYU
5,1,23,41,100,28,57,70,296,SIMIYU
4,1,23,8,26,56,60,54,204,SIMIYU
2,1,23,6,14,8,23,18,69,SIMIYU
1,1,23,81,7,8,43,61,200,SIMIYU
2,1,23,1,17,0,4,14,36,SIMIYU
2,1,23,3,23,17,5,13,61,SIMIYU
4,1,23,1,4,1,11,13,30,SIMIYU
2,1,23,3,11,1,4,19,38,SIMIYU
5,1,23,9,25,19,16,25,94,SIMIYU
2,1,23,2,12,8,0,9,31,SIMIYU
4,1,23,1,9,11,3,8,32,SIMIYU
2,1,23,1,17,43,4,8,73,SIMIYU
2,1,23,19,21,13,13,10,76,SIMIYU
1,1,23,2,2,0,3,0,7,SIMIYU
1,1,23,5,3,3,0,0,11,SIMIYU
2,1,23,4,17,14,4,11,50,SIMIYU
2,1,23,1,2,1,0,0,4,SIMIYU
1,1,23,1,4,3,0,0,8,SIMIYU
2,1,23,3,0,0,0,2,5,SIMIYU
5,1,23,0,3,7,4,0,14,SIMIYU
2,1,23,2,9,6,4,10,31,SIMIYU
5,1,23,11,11,0,0,4,26,SIMIYU
2,1,23,9,25,5,0,11,50,SIMIYU
2,1,23,4,7,3,2,4,20,SIMIYU
1,1,23,5,7,7,2,4,25,SIMIYU
2,1,23,7,17,2,2,7,35,SIMIYU
2,1,23,14,22,2,2,13,53,SIMIYU
2,1,23,1,2,0,0,3,6,SIMIYU
2,1,23,2,2,2,1,1,8,SIMIYU
2,1,23,3,6,11,3,3,26,SIMIYU
2,1,23,38,6,2,2,6,54,SIMIYU
1,1,23,1,0,0,0,10,11,SIMIYU
5,1,23,0,2,6,0,3,11,SIMIYU
1,1,23,8,25,19,3,6,61,SIMIYU
4,1,24,64,114,109,516,148,951,SONGWE
4,1,24,64,114,109,516,148,951,SONGWE
4,1,24,131,120,99,646,131,1127,SONGWE
4,1,24,76,123,256,608,153,1216,SONGWE
4,1,24,63,174,21,68,124,450,SONGWE
4,1,24,9,40,18,45,54,166,SONGWE
5,1,13,1,5,1,1,0,8,MBEYA
6,1,13,14,22,3,1,9,49,MBEYA
4,1,24,32,26,12,0,15,85,SONGWE
5,1,13,0,26,45,4,1,76,MBEYA
4,1,24,49,86,18,17,68,238,SONGWE
5,1,13,1,7,0,0,0,8,MBEYA
5,1,13,1,10,1,0,3,15,MBEYA
6,1,13,0,24,8,2,6,40,MBEYA
5,1,13,1,10,1,0,0,12,MBEYA
4,1,24,2,5,1,0,4,12,SONGWE
4,1,24,0,3,1,2,0,6,SONGWE
4,1,24,20,24,0,0,0,44,SONGWE
6,1,13,1,7,4,1,7,20,MBEYA
1,1,25,10,36,24,718,115,903,TABORA
1,1,25,6,53,19,501,123,702,TABORA
1,1,25,13,57,53,511,118,752,TABORA
4,1,25,37,42,45,736,134,994,TABORA
1,1,25,27,90,53,499,121,790,TABORA
4,1,25,4,8,1,2,0,15,TABORA
1,1,25,2,17,2,2,10,33,TABORA
1,1,25,2,3,2,6,20,33,TABORA
1,1,25,49,89,118,68,75,399,TABORA
1,1,25,4,13,7,19,59,102,TABORA
1,1,25,14,13,8,14,40,89,TABORA
5,1,25,55,67,23,47,2,194,TABORA
1,1,25,15,78,43,488,132,756,TABORA
4,1,25,8,112,40,691,156,1007,TABORA
1,1,25,1,5,5,34,21,66,TABORA
1,1,25,0,13,6,32,18,69,TABORA
4,1,25,1,7,5,30,18,61,TABORA
2,1,25,51,85,24,36,33,229,TABORA
1,1,25,1,9,12,41,50,113,TABORA
4,1,25,6,25,15,25,45,116,TABORA
1,1,25,1,7,8,18,41,75,TABORA
1,1,25,2,12,22,16,30,82,TABORA
1,1,25,5,10,10,14,23,62,TABORA
5,1,25,4,7,2,2,8,23,TABORA
1,1,25,3,8,3,0,2,16,TABORA
2,1,25,5,26,19,2,7,59,TABORA
2,1,25,5,26,19,2,7,59,TABORA
5,1,25,5,22,0,1,0,28,TABORA
2,1,25,4,6,4,1,9,24,TABORA
1,1,25,8,7,1,1,12,29,TABORA
1,1,25,3,3,0,0,3,9,TABORA
5,1,25,10,10,3,0,2,25,TABORA
4,1,25,1,6,4,1,0,12,TABORA
4,1,25,5,13,1,1,2,22,TABORA
4,1,25,0,13,2,8,10,33,TABORA
1,1,25,3,14,0,0,12,29,TABORA
4,1,25,0,19,1,2,8,30,TABORA
1,1,25,15,7,4,0,8,34,TABORA
5,1,25,33,25,26,5,15,104,TABORA
1,1,25,0,6,4,5,21,36,TABORA
4,1,25,5,12,3,3,8,31,TABORA
4,1,25,2,2,0,0,4,8,TABORA
4,1,25,0,5,0,0,0,5,TABORA
1,1,25,0,2,0,0,0,2,TABORA
5,1,25,5,32,8,9,28,82,TABORA
5,1,25,0,4,0,0,2,6,TABORA
5,1,25,6,11,1,2,2,22,TABORA
5,1,25,4,7,0,0,14,25,TABORA
5,1,25,1,7,0,0,10,18,TABORA
5,1,25,0,11,0,2,2,15,TABORA
5,1,25,1,10,1,1,2,15,TABORA
6,1,26,34,32,23,243,298,630,TANGA
3,1,26,39,71,30,197,265,602,TANGA
7,1,26,19,40,21,251,325,656,TANGA
3,1,26,43,87,18,212,190,550,TANGA
4,1,26,111,58,21,152,209,551,TANGA
4,1,26,29,44,13,148,221,455,TANGA
5,1,26,12,64,23,190,199,488,TANGA
3,1,26,39,43,31,163,156,432,TANGA
4,1,26,55,170,29,217,115,586,TANGA
2,1,26,26,107,12,57,16,218,TANGA
2,1,26,26,107,12,57,16,218,TANGA
7,1,26,5,106,29,18,18,176,TANGA
4,1,26,19,4,3,34,19,79,TANGA
3,1,26,3,7,0,0,0,10,TANGA
1,1,26,202,284,0,2,157,645,TANGA
5,1,26,7,16,0,0,12,35,TANGA
4,1,26,7,9,0,0,8,24,TANGA
3,1,26,11,5,0,0,7,23,TANGA
5,1,26,9,19,0,0,9,37,TANGA
4,1,26,8,8,0,0,15,31,TANGA
3,1,26,13,8,0,0,8,29,TANGA
5,1,26,30,28,3,1,43,105,TANGA
7,1,26,30,42,7,0,49,128,TANGA
2,1,26,16,29,5,2,14,66,TANGA
6,1,26,51,35,5,0,41,132,TANGA
4,1,26,11,23,0,0,4,38,TANGA
3,1,26,5,0,0,0,0,5,TANGA
3,1,26,0,0,0,1,2,3,TANGA
2,1,26,35,12,0,0,3,50,TANGA
4,1,26,7,19,11,6,8,51,TANGA
5,1,26,11,5,0,0,9,25,TANGA
3,1,26,5,9,0,2,13,29,TANGA
5,1,26,2,2,0,2,0,6,TANGA
2,1,26,7,52,1,0,2,62,TANGA
1,1,26,77,95,6,33,72,283,TANGA
2,1,26,16,29,5,2,14,66,TANGA
3,1,26,26,11,4,2,13,56,TANGA
6,1,26,3,26,1,0,18,48,TANGA
6,1,26,10,3,0,0,11,24,TANGA
7,1,26,15,1,2,0,17,35,TANGA
1,1,26,5,2,0,0,0,7,TANGA
3,1,26,26,11,4,2,13,56,TANGA
1,1,26,44,11,0,0,9,64,TANGA
6,1,26,15,19,0,0,0,34,TANGA
5,1,26,6,11,1,0,5,23,TANGA
4,1,26,52,19,0,1,7,79,TANGA
1,1,26,8,2,1,0,17,28,TANGA
7,1,26,14,24,29,28,20,115,TANGA
2,1,26,9,19,11,0,10,49,TANGA
1,1,26,23,25,3,3,18,72,TANGA
2,1,26,11,36,0,5,18,70,TANGA
7,1,26,18,13,15,0,3,49,TANGA
3,1,26,8,12,0,0,23,43,TANGA
7,1,26,7,18,3,3,42,73,TANGA
1,1,26,24,11,4,2,41,82,TANGA
2,1,26,77,36,15,2,2,132,TANGA
6,1,26,2,8,0,0,4,14,TANGA
4,1,26,18,13,3,0,1,35,TANGA
4,1,26,3,23,0,0,0,26,TANGA
3,1,26,0,1,0,0,0,1,TANGA
6,1,26,12,8,0,0,0,20,TANGA
2,1,26,2,14,0,0,0,16,TANGA
7,1,26,2,2,0,0,5,9,TANGA
7,1,26,0,1,3,0,11,15,TANGA
4,1,26,8,186,5,0,6,205,TANGA
1,1,26,7,4,4,0,2,17,TANGA
2,1,26,2,13,2,0,1,18,TANGA
4,1,26,9,2,2,0,2,15,TANGA
7,1,26,8,7,2,0,6,23,TANGA
4,1,26,0,1,0,0,0,1,TANGA
7,1,26,3,12,2,1,12,30,TANGA
7,1,26,15,31,2,3,11,62,TANGA
7,1,26,1,10,0,0,6,17,TANGA
2,1,26,1,4,2,0,0,7,TANGA
